┌──────────────────────────────────────────────────┐
│░░░░░░░░░░░█░░░█▀▀░█░█░█▀▀░█░░░░░▄▀▄░▀▀█░░░░░░░░░░│
│░░░░░░░░░░░█░░░█▀▀░▀▄▀░█▀▀░█░░░░░█/█░▄▀░░░░░░░░░░░│
│░░░░░░░░░░░▀▀▀░▀▀▀░░▀░░▀▀▀░▀▀▀░░░░▀░░▀░░░░░░░░░░░░│
└──────────────────────────────────────────────────┘
┌──────────────────────────────────────────────────┐
│                                                  │
│                                                  │
│                                                  │
│                                                  │
│                                                  │
│                                                  │
│                                                  │
│                                                  │
│                                                  │
│                                                  │
└──────────────────────────────────────────────────┘
