┌──────────────────────────────────────────────────┐
│░░░░░░░░░░░█░░░█▀▀░█░█░█▀▀░█░░░░░▄▀▄░▄▀▄░░░░░░░░░░│
│░░░░░░░░░░░█░░░█▀▀░▀▄▀░█▀▀░█░░░░░█/█░▄▀▄░░░░░░░░░░│
│░░░░░░░░░░░▀▀▀░▀▀▀░░▀░░▀▀▀░▀▀▀░░░░▀░░░▀░░░░░░░░░░░│
└──────────────────────────────────────────────────┘
┌──────────────────────────────────────────────────┐
│                                                  │
│                                                  │
│                                                  │
│                                                  │
│                                                  │
│                                                  │
│                                                  │
│                                                  │
│                                                  │
│                                                  │
└──────────────────────────────────────────────────┘
