┌──────────────────────────────────────────────────┐
│░░░░░░░░░░░█░░░█▀▀░█░█░█▀▀░█░░░░░▄▀▄░▄▀▀░░░░░░░░░░│
│░░░░░░░░░░░█░░░█▀▀░▀▄▀░█▀▀░█░░░░░█/█░█▀▄░░░░░░░░░░│
│░░░░░░░░░░░▀▀▀░▀▀▀░░▀░░▀▀▀░▀▀▀░░░░▀░░░▀░░░░░░░░░░░│
└──────────────────────────────────────────────────┘
┌──────────────────────────────────────────────────┐
│                                                  │
│                                                  │
│                                                  │
│                                                  │
│                                                  │
│                                                  │
│                                                  │
│                                                  │
│                                                  │
│                                                  │
└──────────────────────────────────────────────────┘
