┌──────────────────────────────────────────────────┐
│░░░░░░░░░░░█░░░█▀▀░█░█░█▀▀░█░░░░░▄▀▄░▀▀▄░░░░░░░░░░│
│░░░░░░░░░░░█░░░█▀▀░▀▄▀░█▀▀░█░░░░░█/█░▄▀░░░░░░░░░░░│
│░░░░░░░░░░░▀▀▀░▀▀▀░░▀░░▀▀▀░▀▀▀░░░░▀░░▀▀▀░░░░░░░░░░│
└──────────────────────────────────────────────────┘
┌──────────────────────────────────────────────────┐
│                                                  │
│                                                  │
│                                                  │
│                                                  │
│                                                  │
│                                                  │
│                                                  │
│                                                  │
│                                                  │
│                                                  │
└──────────────────────────────────────────────────┘
