┌──────────────────────────────────────────────────┐
│░░░░░░░░░░░█░░░█▀▀░█░█░█▀▀░█░░░░░▄▀▄░▀▀█░░░░░░░░░░│
│░░░░░░░░░░░█░░░█▀▀░▀▄▀░█▀▀░█░░░░░█/█░░▀▄░░░░░░░░░░│
│░░░░░░░░░░░▀▀▀░▀▀▀░░▀░░▀▀▀░▀▀▀░░░░▀░░▀▀░░░░░░░░░░░│
└──────────────────────────────────────────────────┘
┌──────────────────────────────────────────────────┐
│                                                  │
│                                                  │
│                                                  │
│                                                  │
│                                                  │
│                                                  │
│                                                  │
│                                                  │
│                                                  │
│                                                  │
└──────────────────────────────────────────────────┘
